**********
*P   *   *
*        *
*        *
*        *
*    *   *
*    *   *
*  *******
*       G*
**********